15 15 0
***********d***
*.............*
*.............*
*...***.......*
*.............*
*.?.......*...*
*.............*
*.....**......*
*.....**......*
*.............*
*.............*
*********.....*
d.............*
*.............*
******d********