15 13 0
***********d***
*.............*
*..**.....**..*
*..*..........*
*.............*
*...*.........*
*...*....*....*
d...*.........*
*...*......*..*
*...*****..*..*
*..........*..d
*.............*
******d********