20 20 0
**********d*********
*..................*
*..................*
*....*.............*
*....*.............*
d........*.........*
*.......***........*
*..................*
***................*
*****.......*......*
******.....**......*
*******............*
********...........*
*********..........*
**********.........*
***********........*
***********........*
**********.........*
*********..........*
*************d******