10 7 0
**d*******
*....*...*
*....*...*
d....*...*
***..*..**
*........*
*****d****