20 5 0
**********d*********
*.............*....*
*....**......**....d
*..................*
*d******************