9 5 0
*********
*..*....*
*..*....d
*......**
***d*****