10 10 0
**d*******
*....*...d
*....*...*
d........*
**.......*
*....**..*
*..*.....*
*..*.....*
*........*
**d*******