9 5
*********
*.......*
*.......d
*.......*
***d*****