10 7
**********
*.......*.
*.......*.
*.......*.
*********.
..........
**********