10 7
**d*******
*.......**
*.......**
d.......**
*****.****
*........*
*****d****